111111111111111
100001000000031
100000000000001
111111000000001
100000000000061
00sss0000000000
000000011110000
000000010010000
000000014010000
200000010710000
001010010010000
001010000000000
101010000100001
100510000100001
111111111111111
