111111111111111
140000000000001
100000050010001
100000000010001
111111100010001
000000000010000
000000000010000
ssss00300000000
100000100000001
100000100000001
100000100000001
100000100000001
100000100000001
100000120000001
111111111111111
