160000000020001
000000000000000
000000000000000
s00000000000000
s00030000000000
s00000000000000
s00000000000000
s00000000000000
s00000000700000
s00000000000000
000500000000000
000000000000000
000000008000000
000000000000000
100000000000041

